5,0,0,0,0,	//城番号
5500,666666,1,1,6,10,0,0,0,0,	//幅,	城体力,	生産最低F,生産最高F,	背景種類,	出現最大数,以後未使用
207,1,0,1,1,100,8,8,0,100,	//ID,出現数(0で無制限),初登場F,再登場最低F,再登場最高F,城連動出現％,手前ライン,奥ライン,ボスフラグ,強さ倍率
207,1,550,1,1,100,4,4,0,100,
207,1,675,1,1,100,2,2,0,100,
207,1,800,1,1,100,6,6,0,100,
207,1,2000,1,1,100,5,5,0,100,
207,1,2075,1,1,100,3,3,0,100,
207,1,2150,1,1,100,7,7,0,100,
207,1,2225,1,1,100,1,1,0,100,
207,1,2300,1,1,100,9,9,0,100,
23,0,13500,13500,13500,100,9,9,0,100,
0,0,0,0,0,0,0,9,0,100,
0,0,0,0,0,0,0,9,0,100,
0,0,0,0,0,0,0,9,0,100,
0,0,0,0,0,0,0,9,0,100,
0,0,0,0,0,0,0,9,0,100,
0,0,0,0,0,0,0,9,0,100,
0,0,0,0,0,0,0,9,0,100,
0,0,0,0,0,0,0,9,0,100,
0,0,0,0,0,0,0,9,0,100,
0,0,0,0,0,0,0,9,0,100,
0,0,0,0,0,0,0,9,0,100,
0,0,0,0,0,0,0,9,0,100,
0,0,0,0,0,0,0,9,0,100,


//敵は１ステージ最大１０種類
