0,0,0,0,0,0,   //城番号
5500,500000,1,1,3,15,0,0,0,0,    //幅,    城体力,    生産最低F,生産最高F,    背景種類,    出現最大数,以後未使用
289,4,100,160,190,100,0,4,0,200,　//ID,出現数(0で無制限),初登場F,再登場最低F,再登場最高F,城連動出現％,手前ライン,奥ライン,ボスフラグ,強さ倍率
287,8,750,300,300,100,7,9,0,200,
294,8,850,300,350,100,7,9,0,200,
289,0,200,200,150,99,0,4,0,200,
289,7,90,160,190,99,0,4,0,200,
40,2,100,1300,1300,99,5,6,0,300,
289,1,50,120,150,99,0,4,1,10,
23,0,13500,13500,13500,100,9,9,0,100,
0,0,0,0,0,0,0,9,0,100,
0,0,0,0,0,0,0,9,0,100,
0,0,0,0,0,0,0,9,0,100,
0,0,0,0,0,0,0,9,0,100,
0,0,0,0,0,0,0,9,0,100,
0,0,0,0,0,0,0,9,0,100,
0,0,0,0,0,0,0,9,0,100,
0,0,0,0,0,0,0,9,0,100,
0,0,0,0,0,0,0,9,0,100,
0,0,0,0,0,0,0,9,0,100,
0,0,0,0,0,0,0,9,0,100,
0,0,0,0,0,0,0,9,0,100,
0,0,0,0,0,0,0,9,0,100,
0,0,0,0,0,0,0,9,0,100,
0,0,0,0,0,0,0,9,0,100,


//敵は１ステージ最大１０種類
