24,0,0,0,0,0,   //城番号 ke3
6000,10000,2,60,9,8,0,0,0,0,	//幅,	城体力,	生産最低F,生産最高F,	背景種類,	出現最大数,以後未使用
30,0,600,30,600,100,4,9,0,400,	//ID,出現数(0で無制限),初登場F,再登場最低F,再登場最高F,城連動出現％,手前ライン,奥ライン,ボスフラグ,強さ倍率
32,1,100,10,10,100,6,6,1,400,
31,1,100,0,300,100,0,0,0,400,
30,2,0,30,450,100,6,9,0,400,
18,4,3870,30,120,100,0,8,0,400,
31,1,300,0,300,100,8,8,0,400,
23,1,3000,300,300,100,9,9,0,400,
0,0,0,0,0,0,0,9,0,100,
0,0,0,0,0,0,0,9,0,100,
0,0,0,0,0,0,0,9,0,100,
0,0,0,0,0,0,0,9,0,100,
0,0,0,0,0,0,0,9,0,100,
0,0,0,0,0,0,0,9,0,100,
0,0,0,0,0,0,0,9,0,100,
0,0,0,0,0,0,0,9,0,100,
0,0,0,0,0,0,0,9,0,100,
0,0,0,0,0,0,0,9,0,100,
0,0,0,0,0,0,0,9,0,100,
0,0,0,0,0,0,0,9,0,100,
0,0,0,0,0,0,0,9,0,100,
0,0,0,0,0,0,0,9,0,100,
0,0,0,0,0,0,0,9,0,100,
0,0,0,0,0,0,0,9,0,100,
0,0,0,0,0,0,0,9,0,100,
0,0,0,0,0,0,0,9,0,100,
0,0,0,0,0,0,0,9,0,100,
0,0,0,0,0,0,0,9,0,100,


//敵は１ステージ最大１０種類
