136,1,0,0,0,0,   //城番号
4800,1425000,1,1,6,10,0,0,0,0,
362,0,100,460,520,100,1,9,0,2700,
116,3,100,220,300,100,1,9,0,1000,
186,6,400,540,600,100,1,9,0,2050,
363,0,1500,560,600,100,1,9,0,2700,
116,3,1900,220,300,100,1,9,0,1000,
362,3,2500,220,300,100,1,9,0,2700,
363,3,600,860,900,99,1,9,0,2700,
501,1,50,1,1,99,8,8,1,19500,
342,1,50,1,1,99,9,9,0,214,
116,0,100,320,420,99,1,9,0,1000,
117,1,1,820,860,99,1,9,0,500,
117,6,1,720,760,99,1,9,0,500,
0,0,0,0,0,0,0,9,0,100,
0,0,0,0,0,0,0,9,0,100,
0,0,0,0,0,0,0,9,0,100,
0,0,0,0,0,0,0,9,0,100,
0,0,0,0,0,0,0,9,0,100,
0,0,0,0,0,0,0,9,0,100,
0,0,0,0,0,0,0,9,0,100,
0,0,0,0,0,0,0,9,0,100,
0,0,0,0,0,0,0,9,0,100,
0,0,0,0,0,0,0,9,0,100,
0,0,0,0,0,0,0,9,0,100,


//敵は１ステージ最大１０種類
