45,1,0,0,0,0,   //城番号
4800,270000,1,1,13,15,0,0,0,0,	//幅,	城体力,	生産最低F,生産最高F,	背景種類,	出現最大数,以後未使用
41,1,50,1,1,100,3,3,1,150,	//ID,出現数(0で無制限),初登場F,再登場最低F,再登場最高F,城連動出現％,手前ライン,奥ライン,ボスフラグ,強さ倍率
157,0,75,100,200,100,4,9,0,800,
156,0,100,100,200,100,4,9,0,800,
155,5,150,250,300,100,7,9,0,800,
7,0,1800,300,600,100,7,9,0,800,
115,1,400,1,1,100,0,2,0,150,
117,1,800,1,1,100,0,2,0,100,
115,1,1200,1,1,100,0,2,0,150,
115,1,1250,1,1,100,0,2,0,150,
117,1,1700,1,1,100,0,2,0,100,
117,1,1750,1,1,100,0,2,0,100,
23,0,13500,13500,13500,100,9,9,0,100,
0,0,0,0,0,0,0,9,0,100,
0,0,0,0,0,0,0,9,0,100,
0,0,0,0,0,0,0,9,0,100,
0,0,0,0,0,0,0,9,0,100,
0,0,0,0,0,0,0,9,0,100,
0,0,0,0,0,0,0,9,0,100,