136,1,0,0,0,0,   //城番号
5500,975000,1,1,10,12,0,0,0,0,
48,5,50,250,250,100,1,9,0,650,
286,5,50,250,250,100,1,9,0,200,
53,1,700,870,870,100,1,9,0,200,
291,1,700,870,870,100,1,9,0,150,
53,4,600,870,870,99,1,9,0,200,
291,4,600,870,870,99,1,9,0,150,
54,3,300,740,740,99,5,7,0,200,
293,3,300,740,740,99,5,7,0,126,
501,1,1,1,1,99,8,8,1,9000,
48,0,50,420,420,99,1,9,0,650,
286,0,50,420,420,99,1,9,0,200,
48,5,50,250,250,99,1,9,0,650,
286,5,50,250,250,99,1,9,0,200,
0,0,0,0,0,0,0,9,0,100,
0,0,0,0,0,0,0,9,0,100,
0,0,0,0,0,0,0,9,0,100,
0,0,0,0,0,0,0,9,0,100,
0,0,0,0,0,0,0,9,0,100,
0,0,0,0,0,0,0,9,0,100,
0,0,0,0,0,0,0,9,0,100,
0,0,0,0,0,0,0,9,0,100,
0,0,0,0,0,0,0,9,0,100,
0,0,0,0,0,0,0,9,0,100,


//敵は１ステージ最大１０種類
