4,0,0,0,0,0,   //城番号
5000,800000,1,1,140,8,0,0,0,0,	//幅,	城体力,	生産最低F,生産最高F,	背景種類,	出現最大数,以後未使用
311,0,150,400,450,100,1,9,0,400,
425,1,300,1,1,100,1,1,1,100,
306,1,300,1,1,100,3,3,0,250,
409,12,450,200,240,100,1,9,0,100,
292,3,800,550,600,100,1,9,0,300,

//敵は１ステージ最大１０種類