12,0,0,0,0,0,   //城番号
4000,220000,1,1,7,15,0,0,0,0,	//幅,	城体力,	生産最低F,生産最高F,	背景種類,	出現最大数,以後未使用
169,0,100,150,200,100,1,9,0,1000,
58,1,300,1,1,100,1,9,0,200,
170,10,200,300,30,99,1,9,0,1000,
499,0,300,15,15,99,7,9,0,100,
180,1,1,1,1,99,1,1,0,600,
58,1,1,1,1,99,7,7,0,200,
56,1,1,1,1,99,4,4,1,100,
23,0,13500,13500,13500,100,9,9,0,100,
0,0,0,0,0,0,0,9,0,100,
0,0,0,0,0,0,0,9,0,100,
0,0,0,0,0,0,0,9,0,100,
0,0,0,0,0,0,0,9,0,100,
0,0,0,0,0,0,0,9,0,100,
0,0,0,0,0,0,0,9,0,100,
0,0,0,0,0,0,0,9,0,100,
0,0,0,0,0,0,0,9,0,100,
0,0,0,0,0,0,0,9,0,100,
0,0,0,0,0,0,0,9,0,100,
0,0,0,0,0,0,0,9,0,100,
0,0,0,0,0,0,0,9,0,100,
0,0,0,0,0,0,0,9,0,100,
0,0,0,0,0,0,0,9,0,100,
0,0,0,0,0,0,0,9,0,100,

//敵は１ステージ最大１０種類