10,0,0,0,0,0,   //城番号
4200,999999,1,1,134,7,0,0,0,0,
414,3,150,100,100,100,1,9,0,100,
543,1,300,1,1,100,5,9,0,100,
414,3,500,100,150,100,1,9,0,100,
414,10,1,150,250,99,1,9,0,100,
414,35,1,30,30,99,1,9,0,100,
37,1,1,1,1,99,1,1,1,400,
543,4,1,800,800,99,5,9,0,100,


//敵は１ステージ最大１０種類