13,1,0,0,0,0,   //城番号
5000,1000000,1,1,64,10,0,0,0,0,	//幅,	城体力,	生産最低F,生産最高F,	背景種類,	出現最大数,以後未使用
382,1,150,1,1,100,0,0,1,100,	//ID,出現数(0で無制限),初登場F,再登場最低F,再登場最高F,城連動出現％,手前ライン,奥ライン,ボスフラグ,強さ倍率
148,0,450,300,450,100,1,9,0,200,
148,0,1350,450,600,100,1,9,0,200,
148,0,2250,600,900,100,1,9,0,200,
256,0,900,600,800,100,1,9,0,200,
256,0,1800,800,1000,100,1,9,0,200,
256,0,2700,1000,1200,100,1,9,0,200,
116,0,1500,900,1200,100,1,9,0,400,
256,20,0,20,30,90,1,9,0,200,
23,0,13500,13500,13500,100,9,9,0,100,
0,0,0,0,0,0,0,9,0,100,
0,0,0,0,0,0,0,9,0,100,
0,0,0,0,0,0,0,9,0,100,
0,0,0,0,0,0,0,9,0,100,
0,0,0,0,0,0,0,9,0,100,
0,0,0,0,0,0,0,9,0,100,
0,0,0,0,0,0,0,9,0,100,
0,0,0,0,0,0,0,9,0,100,
0,0,0,0,0,0,0,9,0,100,
0,0,0,0,0,0,0,9,0,100,
0,0,0,0,0,0,0,9,0,100,
0,0,0,0,0,0,0,9,0,100,
0,0,0,0,0,0,0,9,0,100,


//敵は１ステージ最大１０種類
