1,0,0,0,0,0,   //城番号
4800,500000,1,1,4,8,0,0,0, //幅,城体力,生産最低F,生産最高F,背景種類,出現最大数,以後未使用
16,0,1,50,150,100,2,6,0,1800,
120,5,150,100,300,100,0,0,0,200,
40,1,300,150,600,99,1,4,0,200,
25,1,50,50,50,99,0,2,1,800,
23,0,13500,13500,13500,100,9,9,0,100,
0,0,0,0,0,0,0,9,0,0,
0,0,0,0,0,0,0,9,0,0,
0,0,0,0,0,0,0,9,0,0,
0,0,0,0,0,0,0,9,0,0,
0,0,0,0,0,0,0,9,0,0,
0,0,0,0,0,0,0,9,0,0,
0,0,0,0,0,0,0,9,0,0,
0,0,0,0,0,0,0,9,0,0,
0,0,0,0,0,0,0,9,0,0,
0,0,0,0,0,0,0,9,0,0,
0,0,0,0,0,0,0,9,0,0,
0,0,0,0,0,0,0,9,0,0,
0,0,0,0,0,0,0,9,0,0,