13,0,0,0,0,0,   //城番号
4600,1100000,1,1,97,8,0,0,0,0,
172,4,200,1050,1100,100,1,5,0,2400,
288,2,350,300,350,100,1,9,0,300,
426,1,1,1,1,99,5,5,0,100,
187,1,1,1,1,99,3,3,0,150,
121,1,1,1,1,99,0,0,1,150,
357,1,1,1,1,99,7,7,0,150,
288,0,1,800,850,99,1,9,0,300,

//敵は１ステージ最大１０種類