1,0,0,0,0,0,   //城番号
5500,1500000,1,1,10,15,0,0,0,0,
292,2,200,400,450,100,4,9,0,300,
173,3,500,100,150,100,1,3,0,2400,
292,3,1,500,600,99,4,9,0,300,
292,3,1,500,600,99,4,9,0,300,
268,1,1,1,1,99,2,2,1,150,
176,1,1,1,1,99,1,1,0,1600,
162,2,1,700,750,99,17,9,0,250,
173,1,500,100,150,99,1,3,0,2400,

//敵は１ステージ最大１０種類
