117,1,0,0,0,0,   //城番号
5800,1222222,1,1,147,6,0,0,0,0,
120,0,250,300,350,100,4,9,0,500,
537,1,250,1,1,100,3,3,1,100,
10,3,300,400,450,100,4,9,0,4000,
207,1,500,1,1,100,4,7,0,150,
414,5,700,350,380,100,4,9,0,100,
10,5,1800,350,400,100,4,9,0,4000,
415,1,1800,1,1,100,2,2,0,100,
414,0,2200,450,480,100,4,9,0,100,
414,8,1,10,15,75,4,9,0,100,


//敵は１ステージ最大１０種類