-1,0,0,0,0,0,
3800,150000,1,1,45,10,0,0,0,0,
5,1,1,1,1,100,0,6,0,1200,
4,0,150,50,150,100,0,8,0,1200,
171,3,1,150,150,90,4,6,0,500,
288,3,150,200,1,90,7,9,0,150,
291,2,250,250,1,90,7,9,0,150,
4,1,0,1,1,90,0,0,1,100,
23,0,13500,13500,13500,100,9,9,0,100,
0,0,0,0,0,0,0,9,0,100,
0,0,0,0,0,0,0,9,0,100,
0,0,0,0,0,0,0,9,0,100,
0,0,0,0,0,0,0,9,0,100,
0,0,0,0,0,0,0,9,0,100,
0,0,0,0,0,0,0,9,0,100,
0,0,0,0,0,0,0,9,0,100,
0,0,0,0,0,0,0,9,0,100,
0,0,0,0,0,0,0,9,0,100,
0,0,0,0,0,0,0,9,0,100,
0,0,0,0,0,0,0,9,0,100,
0,0,0,0,0,0,0,9,0,100,
0,0,0,0,0,0,0,9,0,100,
0,0,0,0,0,0,0,9,0,100,
0,0,0,0,0,0,0,9,0,100,
