10,1,0,0,0,0,   //城番号
4500,1000000,1,1,5,12,0,0,0, //幅,城体力,生産最低F,生産最高F,背景種類,出現最大数,以後未使用
48,5,100,75,150,100,0,9,0,800,
49,1,50,600,600,100,0,6,0,300,
53,3,500,600,600,100,0,6,0,300,
149,1,250,900,900,100,6,6,0,300,
48,0,0,100,200,99,0,9,0,800,
149,3,1,700,750,99,6,6,0,300,
58,1,1,1000,1000,99,8,8,0,200,
418,1,1,1,10,99,9,9,1,500,
23,0,13500,13500,13500,100,9,9,0,100,
0,0,0,0,0,0,0,9,0,0,
0,0,0,0,0,0,0,9,0,0,
0,0,0,0,0,0,0,9,0,0,
0,0,0,0,0,0,0,9,0,0,
0,0,0,0,0,0,0,9,0,0,
0,0,0,0,0,0,0,9,0,0,
0,0,0,0,0,0,0,9,0,0,
0,0,0,0,0,0,0,9,0,0,
0,0,0,0,0,0,0,9,0,0,