11,1,0,0,0,0,   //城番号
4500,350000,1,1,9,6,0,0,0,0,	//幅,	城体力,	生産最低F,生産最高F,	背景種類,	出現最大数,以後未使用
16,0,0,200,300,100,0,9,0,1024,	//ID,出現数(0で無制限),初登場F,再登場最低F,再登場最高F,城連動出現％,手前ライン,奥ライン,ボスフラグ,強さ倍率
10,1,250,1,1,100,0,9,0,1024,
116,3,500,100,150,100,7,9,0,168,
116,0,0,200,300,99,7,9,0,168,
19,2,0,500,500,99,0,2,0,756,
116,3,0,1,1,99,7,9,0,168,
16,3,0,1,1,99,4,9,0,1024,
115,4,0,250,300,99,4,6,0,168,
89,1,0,1,1,99,3,3,1,324,
23,0,13500,13500,13500,100,9,9,0,100,
0,0,0,0,0,0,0,9,0,100,
0,0,0,0,0,0,0,9,0,100,
0,0,0,0,0,0,0,9,0,100,
0,0,0,0,0,0,0,9,0,100,
0,0,0,0,0,0,0,9,0,100,
0,0,0,0,0,0,0,9,0,100,
0,0,0,0,0,0,0,9,0,100,
0,0,0,0,0,0,0,9,0,100,


//敵は１ステージ最大１０種類
