17,0,0,0,0,0,   //城番号
4800,1080000,1,1,7,10,0,0,0,0,	//幅,	城体力,	生産最低F,生産最高F,	背景種類,	出現最大数,以後未使用
549,1,50,1,1,100,6,9,0,100,
44,4,100,200,250,100,1,9,0,1000,
549,2,1,400,400,99,6,9,0,100,
549,3,1,400,400,99,6,9,0,100,
34,1,1,1,1,99,3,3,0,300,
268,1,1,1,1,99,1,1,1,150,
44,6,1,200,250,99,1,9,0,1000,


//敵は１ステージ最大１０種類