0,0,0,0,0,0,   //城番号
4200,1000000,1,1,2,10,524,0,0,0,	//幅,	城体力,	生産最低F,生産最高F,	背景種類,	出現最大数,以後未使用
524,1,0,1,1,100,0,0,0,40000,	//ID,出現数(0で無制限),初登場F,再登場最低F,再登場最高F,城連動出現％,手前ライン,奥ライン,ボスフラグ,強さ倍率
540,3,150,200,250,100,7,9,0,100,
44,5,500,500,550,100,1,6,0,1000,
540,8,850,400,450,100,7,9,0,100,
41,1,1000,1,1,100,1,1,1,400,
34,1,1000,1,1,100,3,3,0,300,
540,13,1000,150,200,100,7,9,0,100,
540,0,3500,500,550,100,7,9,0,100,

//敵は１ステージ最大１０種類