85,0,0,0,0,0,   //城番号
4800,2400,1,1,151,30,0,0,0, //幅,城体力,生産最低F,生産最高F,背景種類,出現最大数,以後未使用
2,0,100,100,200,100,0,0,0,100
6,1,300,15,30,90,6,6,1,100
23,0,13500,13500,13500,100,9,9,0,
0,0,0,0,0,0,0,9,0,
0,0,0,0,0,0,0,9,0,
0,0,0,0,0,0,0,9,0,
0,0,0,0,0,0,0,9,0,
0,0,0,0,0,0,0,9,0,
0,0,0,0,0,0,0,9,0,
0,0,0,0,0,0,0,9,0,
0,0,0,0,0,0,0,9,0,
0,0,0,0,0,0,0,9,0,
0,0,0,0,0,0,0,9,0,
0,0,0,0,0,0,0,9,0,
0,0,0,0,0,0,0,9,0,
0,0,0,0,0,0,0,9,0,
0,0,0,0,0,0,0,9,0,
0,0,0,0,0,0,0,9,0,


//敵は１ステージ最大１０種類
