7,1,100,035,00,01,   //城番号
4900,650000,1,1,0,20,0,0,0,0,	//幅,	城体力,	生産最低F,生産最高F,	背景種類,	出現最大数,以後未使用
291,1,100,1,1,100,1,9,0,200,
149,2,100,150,250,100,9,9,0,100,
364,2,300,1050,1100,100,1,9,0,100,
53,0,100,600,650,99,1,9,0,250,
117,2,1,800,850,99,1,0,0,150,
291,1,1,1,1,99,1,9,0,200,
56,1,1,1,1,99,1,1,1,100,

//敵は１ステージ最大１０種類