17,1,0,0,0,0,   //城番号
4200,750000,1,1,4,10,0,0,0,0,	//幅,	城体力,	生産最低F,生産最高F,	背景種類,	出現最大数,以後未使用
541,1,1,350,500,100,5,7,0,660,
12,2,150,200,250,100,2,3,0,3560,
15,0,1,75,100,99,8,9,0,3560,
11,2,1,475,500,99,0,1,0,3560,
541,5,1,250,250,99,5,7,0,3560,
158,1,1,1,1,99,4,4,1,450,
23,0,13500,13500,13500,100,0,8,0,100,
0,0,0,0,0,0,0,9,0,100,
0,0,0,0,0,0,0,9,0,100,
0,0,0,0,0,0,0,9,0,100,
0,0,0,0,0,0,0,9,0,100,
0,0,0,0,0,0,0,9,0,100,
0,0,0,0,0,0,0,9,0,100,
0,0,0,0,0,0,0,9,0,100,
0,0,0,0,0,0,0,9,0,100,
0,0,0,0,0,0,0,9,0,100,
0,0,0,0,0,0,0,9,0,100,
0,0,0,0,0,0,0,9,0,100,


//敵は１ステージ最大１０種類
