3,1,0,0,0,0,   //城番号
6200,1500000,1,1,9,12,0,0,0,0,   //幅,    城体力,    生産最低F,生産最高F,    背景種類,    出現最大数,以後未使用
259,1,1,1,100,100,0,0,1,100,	//ID,出現数(0で無制限),初登場F,再登場最低F,再登場最高F,城連動出現％,手前ライン,奥ライン,ボスフラグ,強さ倍率
48,6,100,300,300,100,4,6,0,800,
169,2,400,500,500,100,4,6,0,4800,
286,1,200,500,500,100,4,6,0,400,
184,1,1700,1,1,100,4,6,0,800,
293,1,1500,30,60,100,4,6,0,200,
35,3,2300,250,350,100,4,6,0,400,
48,1,3500,1,1,100,4,6,0,800,
48,0,3550,500,900,100,4,6,0,800,
286,2,3500,100,150,100,4,6,0,400,
54,1,3600,180,180,100,4,6,0,300,
17,0,600,250,400,100,4,6,0,3000,
0,0,0,0,0,0,0,9,0,100,
0,0,0,0,0,0,0,9,0,100,
0,0,0,0,0,0,0,9,0,100,
0,0,0,0,0,0,0,9,0,100,
0,0,0,0,0,0,0,9,0,100,
0,0,0,0,0,0,0,9,0,100,
0,0,0,0,0,0,0,9,0,100,
0,0,0,0,0,0,0,9,0,100,
0,0,0,0,0,0,0,9,0,100,
0,0,0,0,0,0,0,9,0,100,
0,0,0,0,0,0,0,9,0,100,


//敵は１ステージ最大１０種類