0,0,0,0,0,0,   //城番号					
4200,1200000,1,1,96,10,526,0,0,0,	//幅,	城体力,	生産最低F,生産最高F,	背景種類,	出現最大数,以後未使用
526,1,1,1,1,100,0,0,0,80000,	//ID,出現数(0で無制限),初登場F,再登場最低F,再登場最高F,城連動出現％,手前ライン,奥ライン,ボスフラグ,強さ倍率
151,1,150,1,1,100,0,0,1,250,
48,0,150,150,250,100,1,9,0,1200,
551,3,300,550,650,100,1,9,0,100,
18,3,750,1200,1250,100,9,9,0,800,
257,1,1500,1,1,100,1,9,0,300,
0,0,0,0,0,0,0,9,0,100,
0,0,0,0,0,0,0,9,0,100,
0,0,0,0,0,0,0,9,0,100,

//敵は１ステージ最大１０種類